//MAP CONVERTED BY dmm2tgm.py THIS HEADER COMMENT PREVENTS RECONVERSION, DO NOT REMOVE
"ab" = (
/obj/effect/spawner/structure/window/reinforced/shutter,
/obj/structure/cable{
	icon_state = "4-8"
	},
/turf/open/floor/plating,
/area/ai_monitored/storage/satellite)
"br" = (
/obj/structure/cable/yellow{
	icon_state = "1-4"
	},
/turf/open/floor/circuit,
/area/ai_monitored/turret_protected/ai)
"bH" = (
/obj/structure/cable/yellow{
	icon_state = "1-2"
	},
/turf/open/floor/plasteel/dark,
/area/ai_monitored/turret_protected/aisat_interior)
"eU" = (
/obj/machinery/power/smes/engineering{
	charge = 5e+006
	},
/obj/structure/cable/yellow,
/turf/open/floor/plating,
/area/ai_monitored/storage/satellite)
"fh" = (
/obj/effect/turf_decal/tile/darkblue{
	dir = 4
	},
/turf/open/floor/plasteel/dark,
/area/ai_monitored/turret_protected/aisat_interior)
"fv" = (
/obj/structure/cable{
	icon_state = "4-8"
	},
/obj/structure/table,
/obj/item/aicard{
	pixel_x = 6;
	pixel_y = 1
	},
/obj/item/assembly/flash/handheld{
	pixel_x = -8;
	pixel_y = 2
	},
/turf/open/floor/plating,
/area/ai_monitored/storage/satellite)
"fM" = (
/obj/machinery/newscaster/security_unit{
	pixel_y = -28
	},
/obj/machinery/computer/aifixer{
	dir = 1
	},
/turf/open/floor/plasteel/grimy,
/area/ai_monitored/turret_protected/aisat_interior)
"fQ" = (
/obj/structure/cable/yellow{
	icon_state = "2-4"
	},
/obj/machinery/space_heater,
/turf/open/floor/plating,
/area/ai_monitored/storage/satellite)
"ge" = (
/obj/structure/cable/yellow{
	icon_state = "4-8"
	},
/obj/structure/cable/yellow{
	icon_state = "1-8"
	},
/turf/open/floor/plasteel/dark,
/area/ai_monitored/turret_protected/aisat_interior)
"gI" = (
/obj/machinery/door/airlock/hatch{
	name = "MiniSat Monitoring Room";
	req_access_txt = "65"
	},
/obj/machinery/door/firedoor/border_only{
	dir = 4
	},
/obj/machinery/door/firedoor/border_only{
	dir = 8
	},
/obj/structure/cable/yellow{
	icon_state = "4-8"
	},
/turf/open/floor/plasteel/grimy,
/area/ai_monitored/turret_protected/aisat_interior)
"hi" = (
/turf/open/floor/plasteel/dark,
/area/ai_monitored/turret_protected/ai)
"hD" = (
/obj/machinery/power/apc{
	areastring = "/area/ai_monitored/turret_protected/aisat_interior";
	dir = 1;
	name = "MiniSat Antechamber APC";
	pixel_y = 23
	},
/turf/open/floor/circuit,
/area/ai_monitored/turret_protected/aisat_interior)
"hZ" = (
/obj/structure/chair/office/dark,
/obj/structure/cable/yellow{
	icon_state = "1-2"
	},
/turf/open/floor/plasteel/grimy,
/area/ai_monitored/turret_protected/aisat_interior)
"ip" = (
/turf/closed/wall,
/area/hallway/primary/central)
"iY" = (
/obj/structure/cable/yellow{
	icon_state = "2-8"
	},
/obj/machinery/requests_console{
	department = "AI";
	departmentType = 5;
	pixel_y = 32
	},
/turf/open/floor/plasteel/dark,
/area/ai_monitored/turret_protected/ai)
"iZ" = (
/obj/effect/turf_decal/tile/darkblue{
	dir = 8
	},
/turf/open/floor/plasteel/dark,
/area/ai_monitored/turret_protected/aisat_interior)
"jv" = (
/obj/effect/spawner/structure/window/reinforced/shutter,
/turf/open/floor/plating,
/area/ai_monitored/turret_protected/aisat_interior)
"mq" = (
/turf/closed/wall/r_wall,
/area/ai_monitored/turret_protected/ai)
"mP" = (
/obj/structure/cable{
	icon_state = "4-8"
	},
/obj/structure/table,
/obj/machinery/cell_charger,
/obj/item/stock_parts/cell/high{
	pixel_x = 3;
	pixel_y = 7
	},
/turf/open/floor/plating,
/area/ai_monitored/storage/satellite)
"oS" = (
/obj/item/twohanded/required/kirbyplants/random,
/turf/open/floor/plasteel/grimy,
/area/ai_monitored/turret_protected/aisat_interior)
"pd" = (
/turf/closed/wall/r_wall,
/area/bridge)
"pL" = (
/obj/effect/spawner/structure/window/reinforced/shutter,
/turf/open/floor/plating,
/area/ai_monitored/storage/satellite)
"qd" = (
/obj/structure/cable/yellow{
	icon_state = "1-2"
	},
/obj/machinery/computer/monitor{
	dir = 1;
	name = "MiniSat power monitoring console"
	},
/turf/open/floor/plasteel/grimy,
/area/ai_monitored/turret_protected/aisat_interior)
"qL" = (
/turf/template_noop,
/area/template_noop)
"ra" = (
/obj/machinery/holopad,
/obj/structure/cable/yellow{
	icon_state = "2-8"
	},
/turf/open/floor/plasteel/grimy,
/area/ai_monitored/turret_protected/aisat_interior)
"ru" = (
/obj/effect/spawner/structure/window/reinforced,
/turf/open/floor/plating,
/area/ai_monitored/turret_protected/ai)
"sG" = (
/obj/structure/sign/departments/minsky/command/charge{
	pixel_y = 32
	},
/turf/template_noop,
/area/template_noop)
"sO" = (
/obj/structure/cable/yellow{
	icon_state = "1-2"
	},
/turf/open/floor/plasteel/dark,
/area/ai_monitored/turret_protected/ai)
"tq" = (
/obj/structure/cable{
	icon_state = "1-4"
	},
/obj/structure/rack,
/obj/item/storage/toolbox/electrical{
	pixel_x = -3;
	pixel_y = 3
	},
/obj/item/storage/toolbox/mechanical,
/obj/item/multitool,
/turf/open/floor/plating,
/area/ai_monitored/storage/satellite)
"uq" = (
/obj/machinery/door/window{
	base_state = "leftsecure";
	dir = 8;
	icon_state = "leftsecure";
	name = "Primary AI Core Access";
	obj_integrity = 300;
	req_access_txt = "16"
	},
/obj/machinery/turretid{
	icon_state = "control_stun";
	name = "AI Chamber turret control";
	pixel_y = -30
	},
/turf/open/floor/circuit,
/area/ai_monitored/turret_protected/ai)
"uX" = (
/obj/structure/extinguisher_cabinet{
	pixel_y = 30
	},
/turf/open/floor/plasteel/grimy,
/area/ai_monitored/turret_protected/aisat_interior)
"uZ" = (
/obj/machinery/light,
/obj/structure/table/wood,
/obj/item/phone{
	pixel_x = 7;
	pixel_y = 1
	},
/obj/item/toy/figure/borg{
	pixel_x = -4;
	pixel_y = -2
	},
/obj/item/flashlight/lamp{
	pixel_x = -4;
	pixel_y = 7
	},
/turf/open/floor/plasteel/grimy,
/area/ai_monitored/turret_protected/aisat_interior)
"vd" = (
/obj/machinery/door/airlock/hatch{
	name = "MiniSat Monitoring Room";
	req_access_txt = "65"
	},
/obj/structure/cable/yellow{
	icon_state = "4-8"
	},
/turf/open/floor/plating,
/area/space)
"wl" = (
/obj/structure/cable/yellow{
	icon_state = "2-8"
	},
/obj/machinery/recharge_station,
/turf/open/floor/plating,
/area/ai_monitored/storage/satellite)
"wR" = (
/obj/structure/cable/yellow{
	icon_state = "4-8"
	},
/turf/open/floor/plasteel/grimy,
/area/ai_monitored/turret_protected/aisat_interior)
"ym" = (
/obj/machinery/power/terminal{
	dir = 1
	},
/obj/structure/cable{
	icon_state = "0-2"
	},
/turf/open/floor/plating,
/area/ai_monitored/storage/satellite)
"zp" = (
/turf/open/floor/plating,
/area/ai_monitored/storage/satellite)
"zs" = (
/obj/structure/cable/yellow{
	icon_state = "1-4"
	},
/turf/open/floor/plating,
/area/ai_monitored/storage/satellite)
"zL" = (
/obj/effect/turf_decal/tile/darkblue{
	dir = 4
	},
/obj/structure/showcase/cyborg/old{
	pixel_y = 24
	},
/obj/machinery/turretid{
	control_area = "/area/ai_monitored/turret_protected/aisat_interior";
	name = "Antechamber Turret Control";
	pixel_x = 32;
	req_access_txt = "19"
	},
/obj/machinery/camera/motion{
	c_tag = "MiniSat Foyer";
	dir = 8;
	network = list("minisat","ss13")
	},
/turf/open/floor/plasteel/dark,
/area/ai_monitored/turret_protected/aisat_interior)
"Ac" = (
/obj/structure/cable/yellow{
	icon_state = "4-8"
	},
/turf/open/floor/plating,
/area/ai_monitored/storage/satellite)
"Aj" = (
/obj/machinery/door/window{
	base_state = "leftsecure";
	dir = 8;
	icon_state = "leftsecure";
	layer = 4.1;
	name = "Tertiary AI Core Access";
	obj_integrity = 300;
	req_access_txt = "16"
	},
/obj/effect/landmark/start/ai/secondary,
/turf/open/floor/circuit/green,
/area/ai_monitored/turret_protected/ai)
"Aq" = (
/obj/structure/cable/yellow{
	icon_state = "1-2"
	},
/turf/open/floor/circuit,
/area/ai_monitored/turret_protected/ai)
"AU" = (
/obj/machinery/porta_turret/ai{
	scan_range = 4
	},
/obj/effect/turf_decal/tile/darkblue{
	dir = 4
	},
/turf/open/floor/plasteel/dark,
/area/ai_monitored/turret_protected/aisat_interior)
"Bo" = (
/obj/structure/cable/yellow{
	icon_state = "4-8"
	},
/turf/open/floor/plasteel/dark,
/area/ai_monitored/turret_protected/ai)
"BE" = (
/obj/effect/turf_decal/tile/darkblue{
	dir = 4
	},
/obj/structure/showcase/cyborg/old{
	dir = 8;
	pixel_x = 9;
	pixel_y = 2
	},
/turf/open/floor/plasteel/dark,
/area/ai_monitored/turret_protected/aisat_interior)
"BM" = (
/obj/structure/cable/yellow{
	icon_state = "2-4"
	},
/turf/open/floor/circuit,
/area/ai_monitored/turret_protected/ai)
"BS" = (
/obj/effect/turf_decal/tile/darkblue,
/turf/open/floor/plasteel/dark,
/area/ai_monitored/turret_protected/aisat_interior)
"BW" = (
/obj/machinery/computer/security/telescreen{
	dir = 8;
	name = "MiniSat Camera Monitor";
	network = list("minisat","aicore");
	pixel_x = 26
	},
/obj/structure/table/wood,
/obj/item/radio/off{
	pixel_x = -6;
	pixel_y = 5
	},
/obj/item/folder{
	pixel_x = 6;
	pixel_y = 2
	},
/turf/open/floor/plasteel/grimy,
/area/ai_monitored/turret_protected/aisat_interior)
"DK" = (
/obj/structure/cable{
	icon_state = "2-8"
	},
/turf/open/floor/plasteel/dark,
/area/ai_monitored/turret_protected/aisat_interior)
"DS" = (
/turf/open/floor/circuit,
/area/ai_monitored/turret_protected/ai)
"Fw" = (
/obj/structure/cable/yellow{
	icon_state = "4-8"
	},
/turf/open/floor/plasteel/dark,
/area/ai_monitored/turret_protected/aisat_interior)
"FS" = (
/obj/structure/cable/yellow{
	icon_state = "1-2"
	},
/obj/machinery/door/poddoor/shutters/preopen{
	id = "AI Chamber entrance shutters";
	name = "AI Chamber entrance shutters"
	},
/obj/machinery/door/airlock/highsecurity{
	name = "AI Core";
	req_access_txt = "16"
	},
/obj/effect/mapping_helpers/airlock/locked,
/obj/machinery/door/firedoor/border_only{
	dir = 1
	},
/obj/machinery/door/firedoor/border_only,
/obj/effect/mapping_helpers/airlock/cyclelink_helper,
/turf/open/floor/circuit,
/area/ai_monitored/turret_protected/aisat_interior)
"Gn" = (
/obj/structure/cable/yellow{
	icon_state = "1-2"
	},
/turf/open/floor/circuit,
/area/ai_monitored/turret_protected/aisat_interior)
"GI" = (
/obj/effect/spawner/structure/window/reinforced/shutter,
/obj/structure/cable/yellow,
/turf/open/floor/plating,
/area/hallway/primary/central)
"Hq" = (
/obj/structure/cable/yellow{
	icon_state = "1-2"
	},
/obj/machinery/door/airlock/hatch{
	name = "MiniSat Antechamber";
	req_access_txt = "65"
	},
/obj/effect/mapping_helpers/airlock/cyclelink_helper{
	dir = 1
	},
/turf/open/floor/plasteel/dark,
/area/ai_monitored/turret_protected/aisat_interior)
"Io" = (
/turf/closed/wall/r_wall,
/area/ai_monitored/storage/satellite)
"IE" = (
/obj/effect/turf_decal/tile/darkblue{
	dir = 1
	},
/turf/open/floor/plasteel/dark,
/area/ai_monitored/turret_protected/aisat_interior)
"IG" = (
/obj/machinery/porta_turret/ai{
	scan_range = 4
	},
/obj/effect/turf_decal/tile/darkblue{
	dir = 1
	},
/turf/open/floor/plasteel/dark,
/area/ai_monitored/turret_protected/aisat_interior)
"JL" = (
/turf/closed/wall/r_wall,
/area/hallway/primary/central)
"ME" = (
/turf/open/floor/plasteel/dark,
/area/ai_monitored/turret_protected/aisat_interior)
"NR" = (
/obj/structure/cable/yellow{
	icon_state = "1-8"
	},
/turf/open/floor/plasteel/dark,
/area/ai_monitored/turret_protected/ai)
"Oa" = (
/obj/effect/landmark/start/ai,
/turf/open/floor/circuit/green,
/area/ai_monitored/turret_protected/ai)
"Qy" = (
/turf/closed/wall/r_wall,
/area/ai_monitored/turret_protected/aisat_interior)
"Ra" = (
/obj/structure/showcase/cyborg/old{
	pixel_y = 24
	},
/turf/open/floor/circuit,
/area/ai_monitored/turret_protected/ai)
"RV" = (
/obj/machinery/door/window{
	base_state = "rightsecure";
	dir = 4;
	icon_state = "rightsecure";
	layer = 4.1;
	name = "Secondary AI Core Access";
	obj_integrity = 300;
	req_access_txt = "16"
	},
/obj/effect/landmark/start/ai/secondary,
/obj/item/radio/intercom{
	freerange = 1;
	frequency = 1447;
	name = "Private Channel";
	pixel_x = -15;
	pixel_y = -25
	},
/obj/item/radio/intercom{
	freerange = 1;
	name = "Common Channel";
	pixel_x = -27
	},
/obj/item/radio/intercom{
	freerange = 1;
	listening = 0;
	name = "Custom Channel";
	pixel_x = -15;
	pixel_y = 25
	},
/turf/open/floor/circuit/green,
/area/ai_monitored/turret_protected/ai)
"Sg" = (
/obj/machinery/airalarm{
	dir = 8;
	pixel_x = 24
	},
/obj/structure/filingcabinet,
/turf/open/floor/plasteel/grimy,
/area/ai_monitored/turret_protected/aisat_interior)
"Tl" = (
/obj/machinery/door/firedoor/border_only{
	dir = 1
	},
/obj/machinery/door/firedoor/border_only,
/obj/machinery/atmospherics/pipe/simple/supply/hidden/layer2,
/obj/machinery/atmospherics/pipe/simple/scrubbers/hidden/layer4,
/obj/machinery/door/airlock/hatch{
	name = "Telecomms Control Room";
	req_access_txt = "61"
	},
/obj/structure/cable{
	icon_state = "1-2"
	},
/obj/effect/mapping_helpers/airlock/cyclelink_helper{
	dir = 1
	},
/obj/structure/cable{
	icon_state = "1-2"
	},
/turf/open/floor/plasteel/grimy,
/area/ai_monitored/turret_protected/aisat_interior)
"Tr" = (
/obj/machinery/door/window{
	base_state = "rightsecure";
	dir = 4;
	icon_state = "rightsecure";
	name = "Primary AI Core Access";
	obj_integrity = 300;
	req_access_txt = "16"
	},
/turf/open/floor/circuit,
/area/ai_monitored/turret_protected/ai)
"Uw" = (
/obj/effect/turf_decal/tile/darkblue{
	dir = 1
	},
/obj/structure/showcase/cyborg/old{
	dir = 4;
	pixel_x = -9;
	pixel_y = 2
	},
/turf/open/floor/plasteel/dark,
/area/ai_monitored/turret_protected/aisat_interior)
"UP" = (
/obj/machinery/flasher{
	id = "AI";
	pixel_x = 5;
	pixel_y = 25
	},
/turf/open/floor/circuit,
/area/ai_monitored/turret_protected/aisat_interior)
"Wr" = (
/turf/open/floor/plasteel/grimy,
/area/ai_monitored/turret_protected/aisat_interior)
"Xi" = (
/obj/structure/cable{
	icon_state = "4-8"
	},
/turf/open/floor/plasteel/dark,
/area/ai_monitored/turret_protected/aisat_interior)
"XF" = (
/obj/machinery/porta_turret/ai,
/turf/open/floor/circuit,
/area/ai_monitored/turret_protected/ai)
"XV" = (
/obj/structure/cable/yellow{
	icon_state = "1-2"
	},
/obj/machinery/holopad,
/turf/open/floor/plasteel/dark,
/area/ai_monitored/turret_protected/aisat_interior)
"Zh" = (
/obj/machinery/power/apc{
	areastring = "/area/ai_monitored/turret_protected/ai";
	dir = 1;
	name = "AI Chamber APC";
	pixel_y = 23
	},
/obj/structure/cable/yellow{
	icon_state = "0-2"
	},
/turf/open/floor/circuit,
/area/ai_monitored/turret_protected/ai)
"Zl" = (
/obj/machinery/camera{
	c_tag = "MiniSat - Monitoring room";
	dir = 8;
	network = list("minisat","ss13")
	},
/obj/machinery/newscaster/security_unit{
	pixel_x = 28
	},
/obj/structure/table/wood,
/obj/item/paper_bin{
	pixel_x = -1;
	pixel_y = 6
	},
/obj/item/pen,
/turf/open/floor/plasteel/grimy,
/area/ai_monitored/turret_protected/aisat_interior)
"ZI" = (
/obj/effect/turf_decal/tile/darkblue{
	dir = 1
	},
/obj/structure/showcase/cyborg/old{
	pixel_y = 24
	},
/obj/structure/sign/departments/minsky/command/charge{
	pixel_x = -32
	},
/turf/open/floor/plasteel/dark,
/area/ai_monitored/turret_protected/aisat_interior)

(1,1,1) = {"
qL
qL
qL
qL
qL
qL
qL
qL
qL
qL
Qy
Qy
Qy
Qy
Qy
fQ
eU
ym
tq
JL
qL
"}
(2,1,1) = {"
qL
qL
mq
mq
mq
RV
mq
mq
mq
mq
Qy
Qy
Uw
iZ
Qy
Ac
zp
zp
mP
JL
qL
"}
(3,1,1) = {"
pd
mq
mq
XF
DS
DS
DS
DS
XF
mq
Qy
IG
ME
ME
Qy
wl
zs
zp
fv
JL
qL
"}
(4,1,1) = {"
pd
mq
Ra
BM
sO
sO
sO
sO
br
DS
Qy
ME
ME
ME
Qy
Io
vd
pL
ab
JL
qL
"}
(5,1,1) = {"
pd
mq
DS
Bo
ru
uq
mq
mq
Bo
DS
Qy
UP
ME
ME
Qy
ZI
Fw
IE
Xi
ip
sG
"}
(6,1,1) = {"
pd
mq
Zh
NR
ru
DS
Oa
mq
iY
Aq
FS
Gn
XV
bH
Hq
bH
ge
ME
DK
Tl
qL
"}
(7,1,1) = {"
pd
mq
DS
hi
ru
Tr
mq
mq
hi
DS
Qy
hD
ME
ME
Qy
zL
Fw
fh
ME
ip
qL
"}
(8,1,1) = {"
pd
mq
Ra
DS
hi
hi
hi
hi
DS
DS
Qy
ME
ME
ME
Qy
Qy
gI
jv
jv
JL
qL
"}
(9,1,1) = {"
pd
mq
mq
XF
DS
DS
DS
DS
XF
mq
Qy
AU
ME
ME
Qy
oS
wR
Wr
fM
JL
qL
"}
(10,1,1) = {"
qL
qL
mq
mq
mq
Aj
mq
mq
mq
mq
Qy
Qy
BE
BS
Qy
uX
ra
hZ
qd
GI
qL
"}
(11,1,1) = {"
qL
qL
qL
qL
qL
qL
qL
qL
qL
qL
Qy
Qy
Qy
Qy
Qy
Sg
Zl
BW
uZ
JL
qL
"}
