//MAP CONVERTED BY dmm2tgm.py THIS HEADER COMMENT PREVENTS RECONVERSION, DO NOT REMOVE
"bE" = (
/turf/closed/wall/r_wall,
/area/ai_monitored/turret_protected/aisat_interior)
"cr" = (
/obj/structure/cable/yellow{
	icon_state = "2-8"
	},
/obj/machinery/requests_console{
	department = "AI";
	departmentType = 5;
	pixel_y = 32
	},
/turf/open/floor/plasteel/dark,
/area/ai_monitored/turret_protected/ai)
"cR" = (
/obj/machinery/light,
/obj/structure/table/wood,
/obj/item/phone{
	pixel_x = 7;
	pixel_y = 1
	},
/obj/item/toy/figure/borg{
	pixel_x = -4;
	pixel_y = -2
	},
/obj/item/flashlight/lamp{
	pixel_x = -4;
	pixel_y = 7
	},
/turf/open/floor/plasteel/grimy,
/area/ai_monitored/turret_protected/aisat_interior)
"cS" = (
/obj/structure/cable/yellow{
	icon_state = "1-8"
	},
/obj/structure/cable/yellow{
	icon_state = "4-8"
	},
/turf/open/floor/plasteel/dark,
/area/ai_monitored/turret_protected/aisat_interior)
"cX" = (
/obj/machinery/holopad,
/obj/structure/cable/yellow{
	icon_state = "2-8"
	},
/turf/open/floor/plasteel/grimy,
/area/ai_monitored/turret_protected/aisat_interior)
"dC" = (
/turf/open/floor/plating,
/area/ai_monitored/storage/satellite)
"eu" = (
/obj/machinery/newscaster/security_unit{
	pixel_y = -28
	},
/obj/machinery/computer/aifixer{
	dir = 1
	},
/turf/open/floor/plasteel/grimy,
/area/ai_monitored/turret_protected/aisat_interior)
"eN" = (
/turf/closed/wall/r_wall,
/area/space)
"eV" = (
/obj/structure/sign/departments/minsky/command/charge{
	pixel_y = 32
	},
/turf/template_noop,
/area/template_noop)
"ff" = (
/obj/effect/turf_decal/tile/darkblue{
	dir = 1
	},
/turf/open/floor/plasteel/dark,
/area/ai_monitored/turret_protected/aisat_interior)
"fR" = (
/obj/structure/cable{
	icon_state = "1-4"
	},
/obj/structure/rack,
/obj/item/storage/toolbox/electrical{
	pixel_x = -3;
	pixel_y = 3
	},
/obj/item/storage/toolbox/mechanical,
/obj/item/multitool,
/turf/open/floor/plating,
/area/ai_monitored/storage/satellite)
"hT" = (
/obj/structure/cable/yellow{
	icon_state = "1-2"
	},
/obj/machinery/holopad,
/turf/open/floor/plasteel/dark,
/area/ai_monitored/turret_protected/aisat_interior)
"iu" = (
/obj/structure/cable/yellow{
	icon_state = "2-4"
	},
/turf/open/floor/circuit,
/area/ai_monitored/turret_protected/ai)
"iE" = (
/obj/machinery/porta_turret/ai{
	scan_range = 4
	},
/obj/effect/turf_decal/tile/darkblue{
	dir = 4
	},
/turf/open/floor/plasteel/dark,
/area/ai_monitored/turret_protected/aisat_interior)
"iS" = (
/turf/closed/wall/r_wall,
/area/ai_monitored/storage/satellite)
"jf" = (
/obj/structure/filingcabinet,
/turf/open/floor/plasteel/grimy,
/area/ai_monitored/turret_protected/aisat_interior)
"jm" = (
/obj/machinery/porta_turret/ai{
	scan_range = 4
	},
/obj/effect/turf_decal/tile/darkblue{
	dir = 1
	},
/turf/open/floor/plasteel/dark,
/area/ai_monitored/turret_protected/aisat_interior)
"jW" = (
/obj/machinery/door/window{
	base_state = "rightsecure";
	dir = 4;
	icon_state = "rightsecure";
	layer = 4.1;
	name = "Secondary AI Core Access";
	obj_integrity = 300;
	req_access_txt = "16"
	},
/obj/effect/landmark/start/ai/secondary,
/obj/item/radio/intercom{
	freerange = 1;
	frequency = 1447;
	name = "Private Channel";
	pixel_x = -15;
	pixel_y = -25
	},
/obj/item/radio/intercom{
	freerange = 1;
	name = "Common Channel";
	pixel_x = -27
	},
/obj/item/radio/intercom{
	freerange = 1;
	listening = 0;
	name = "Custom Channel";
	pixel_x = -15;
	pixel_y = 25
	},
/turf/open/floor/circuit/green,
/area/ai_monitored/turret_protected/ai)
"kp" = (
/obj/machinery/door/window{
	base_state = "rightsecure";
	dir = 4;
	icon_state = "rightsecure";
	name = "Primary AI Core Access";
	obj_integrity = 300;
	req_access_txt = "16"
	},
/turf/open/floor/circuit,
/area/ai_monitored/turret_protected/ai)
"kN" = (
/obj/structure/cable{
	icon_state = "1-2"
	},
/turf/open/floor/plasteel/dark,
/area/ai_monitored/turret_protected/aisat_interior)
"lt" = (
/turf/open/floor/circuit,
/area/ai_monitored/turret_protected/ai)
"lI" = (
/turf/open/floor/plasteel/grimy,
/area/ai_monitored/turret_protected/aisat_interior)
"lR" = (
/obj/machinery/power/smes/engineering{
	charge = 5e+006
	},
/obj/structure/cable/yellow{
	icon_state = "0-4"
	},
/turf/open/floor/plating,
/area/ai_monitored/storage/satellite)
"mx" = (
/obj/machinery/door/firedoor/border_only{
	dir = 1
	},
/obj/machinery/door/firedoor/border_only,
/obj/machinery/atmospherics/pipe/simple/supply/hidden/layer2,
/obj/machinery/atmospherics/pipe/simple/scrubbers/hidden/layer4,
/obj/machinery/door/airlock/hatch{
	name = "Telecomms Control Room";
	req_access_txt = "61"
	},
/obj/structure/cable{
	icon_state = "1-2"
	},
/obj/effect/mapping_helpers/airlock/cyclelink_helper{
	dir = 1
	},
/obj/structure/cable{
	icon_state = "1-2"
	},
/turf/open/floor/plasteel/grimy,
/area/ai_monitored/turret_protected/aisat_interior)
"mC" = (
/turf/open/floor/plasteel/dark,
/area/ai_monitored/turret_protected/aisat_interior)
"mL" = (
/obj/structure/cable/yellow{
	icon_state = "2-8"
	},
/obj/machinery/recharge_station,
/turf/open/floor/plating,
/area/ai_monitored/storage/satellite)
"nO" = (
/turf/open/floor/plasteel/dark,
/area/ai_monitored/turret_protected/ai)
"qi" = (
/turf/template_noop,
/area/template_noop)
"qL" = (
/obj/machinery/door/window{
	base_state = "leftsecure";
	dir = 8;
	icon_state = "leftsecure";
	layer = 4.1;
	name = "Tertiary AI Core Access";
	obj_integrity = 300;
	req_access_txt = "16"
	},
/obj/effect/landmark/start/ai/secondary,
/turf/open/floor/circuit/green,
/area/ai_monitored/turret_protected/ai)
"sw" = (
/obj/machinery/flasher{
	id = "AI";
	pixel_x = 5;
	pixel_y = 25
	},
/turf/open/floor/circuit,
/area/ai_monitored/turret_protected/aisat_interior)
"tW" = (
/obj/effect/spawner/structure/window/reinforced/shutter,
/obj/structure/cable,
/turf/open/floor/plating,
/area/space)
"vj" = (
/obj/structure/showcase/cyborg/old{
	pixel_y = 24
	},
/turf/open/floor/circuit,
/area/ai_monitored/turret_protected/ai)
"vv" = (
/obj/structure/cable/yellow{
	icon_state = "1-2"
	},
/obj/machinery/door/poddoor/shutters/preopen{
	id = "AI Chamber entrance shutters";
	name = "AI Chamber entrance shutters"
	},
/obj/machinery/door/airlock/highsecurity{
	name = "AI Core";
	req_access_txt = "16"
	},
/obj/effect/mapping_helpers/airlock/locked,
/obj/machinery/door/firedoor/border_only{
	dir = 1
	},
/obj/machinery/door/firedoor/border_only,
/obj/effect/mapping_helpers/airlock/cyclelink_helper,
/turf/open/floor/circuit,
/area/ai_monitored/turret_protected/aisat_interior)
"xt" = (
/obj/structure/chair/office/dark,
/obj/structure/cable/yellow{
	icon_state = "1-2"
	},
/turf/open/floor/plasteel/grimy,
/area/ai_monitored/turret_protected/aisat_interior)
"yb" = (
/obj/machinery/porta_turret/ai,
/turf/open/floor/circuit,
/area/ai_monitored/turret_protected/ai)
"yP" = (
/obj/effect/spawner/structure/window/reinforced/shutter,
/turf/open/floor/plating,
/area/ai_monitored/turret_protected/aisat_interior)
"zv" = (
/obj/machinery/power/apc{
	areastring = "/area/ai_monitored/turret_protected/aisat_interior";
	dir = 1;
	name = "MiniSat Antechamber APC";
	pixel_y = 23
	},
/turf/open/floor/circuit,
/area/ai_monitored/turret_protected/aisat_interior)
"AI" = (
/obj/item/twohanded/required/kirbyplants/random,
/turf/open/floor/plasteel/grimy,
/area/ai_monitored/turret_protected/aisat_interior)
"Cv" = (
/obj/structure/cable/yellow{
	icon_state = "1-4"
	},
/turf/open/floor/circuit,
/area/ai_monitored/turret_protected/ai)
"Dr" = (
/obj/structure/cable/yellow{
	icon_state = "1-2"
	},
/turf/open/floor/plating,
/area/ai_monitored/storage/satellite)
"EK" = (
/obj/machinery/camera{
	c_tag = "MiniSat - Monitoring room";
	dir = 8;
	network = list("minisat","ss13")
	},
/obj/machinery/newscaster/security_unit{
	pixel_x = 28
	},
/obj/structure/table/wood,
/obj/item/paper_bin{
	pixel_x = -1;
	pixel_y = 6
	},
/obj/item/pen,
/turf/open/floor/plasteel/grimy,
/area/ai_monitored/turret_protected/aisat_interior)
"Ga" = (
/obj/structure/cable{
	icon_state = "4-8"
	},
/obj/structure/table,
/obj/item/aicard{
	pixel_x = 6;
	pixel_y = 1
	},
/obj/item/assembly/flash/handheld{
	pixel_x = -8;
	pixel_y = 2
	},
/turf/open/floor/plating,
/area/ai_monitored/storage/satellite)
"Gr" = (
/obj/effect/spawner/structure/window/reinforced/shutter,
/obj/structure/cable{
	icon_state = "4-8"
	},
/turf/open/floor/plating,
/area/ai_monitored/storage/satellite)
"Gu" = (
/obj/structure/cable{
	icon_state = "1-2"
	},
/turf/open/floor/plating,
/area/ai_monitored/storage/satellite)
"GZ" = (
/obj/structure/cable/yellow{
	icon_state = "1-4"
	},
/turf/open/floor/plating,
/area/ai_monitored/storage/satellite)
"KM" = (
/obj/structure/cable/yellow{
	icon_state = "1-2"
	},
/obj/machinery/computer/monitor{
	dir = 1;
	name = "MiniSat power monitoring console"
	},
/turf/open/floor/plasteel/grimy,
/area/ai_monitored/turret_protected/aisat_interior)
"Lu" = (
/turf/open/space/basic,
/area/space)
"Lz" = (
/obj/structure/cable{
	icon_state = "4-8"
	},
/obj/structure/table,
/obj/machinery/cell_charger,
/obj/item/stock_parts/cell/high{
	pixel_x = 3;
	pixel_y = 7
	},
/obj/structure/cable{
	icon_state = "2-4"
	},
/turf/open/floor/plating,
/area/ai_monitored/storage/satellite)
"MV" = (
/obj/effect/turf_decal/tile/darkblue{
	dir = 4
	},
/turf/open/floor/plasteel/dark,
/area/ai_monitored/turret_protected/aisat_interior)
"Ny" = (
/obj/machinery/door/airlock/hatch{
	name = "MiniSat Monitoring Room";
	req_access_txt = "65"
	},
/obj/machinery/door/firedoor/border_only{
	dir = 4
	},
/obj/machinery/door/firedoor/border_only{
	dir = 8
	},
/obj/structure/cable/yellow{
	icon_state = "4-8"
	},
/turf/open/floor/plasteel/grimy,
/area/ai_monitored/turret_protected/aisat_interior)
"NE" = (
/obj/machinery/door/window{
	base_state = "leftsecure";
	dir = 8;
	icon_state = "leftsecure";
	name = "Primary AI Core Access";
	obj_integrity = 300;
	req_access_txt = "16"
	},
/obj/machinery/turretid{
	icon_state = "control_stun";
	name = "AI Chamber turret control";
	pixel_y = -30
	},
/turf/open/floor/circuit,
/area/ai_monitored/turret_protected/ai)
"NM" = (
/obj/machinery/computer/security/telescreen{
	dir = 8;
	name = "MiniSat Camera Monitor";
	network = list("minisat","aicore");
	pixel_x = 26
	},
/obj/structure/table/wood,
/obj/item/radio/off{
	pixel_x = -6;
	pixel_y = 5
	},
/obj/item/folder{
	pixel_x = 6;
	pixel_y = 2
	},
/turf/open/floor/plasteel/grimy,
/area/ai_monitored/turret_protected/aisat_interior)
"Oe" = (
/obj/effect/turf_decal/tile/darkblue{
	dir = 1
	},
/obj/structure/showcase/cyborg/old{
	pixel_y = 24
	},
/obj/structure/cable/yellow{
	icon_state = "4-8"
	},
/turf/open/floor/plasteel/dark,
/area/ai_monitored/turret_protected/aisat_interior)
"Ow" = (
/turf/closed/wall/r_wall,
/area/hallway/primary/central)
"Oy" = (
/obj/structure/cable/yellow{
	icon_state = "4-8"
	},
/obj/machinery/power/apc{
	areastring = "/area/ai_monitored/storage/satellite";
	dir = 1;
	name = "MiniSat Maint APC";
	pixel_y = 23
	},
/obj/structure/cable/yellow{
	icon_state = "0-8"
	},
/turf/open/floor/plating,
/area/ai_monitored/storage/satellite)
"Px" = (
/obj/effect/spawner/structure/window/reinforced/shutter,
/turf/open/floor/plating,
/area/hallway/primary/central)
"PT" = (
/obj/structure/cable/yellow{
	icon_state = "1-2"
	},
/turf/open/floor/circuit,
/area/ai_monitored/turret_protected/ai)
"Qb" = (
/obj/structure/cable/yellow{
	icon_state = "1-8"
	},
/turf/open/floor/plasteel/dark,
/area/ai_monitored/turret_protected/ai)
"RF" = (
/turf/closed/wall/r_wall,
/area/ai_monitored/turret_protected/ai)
"Sv" = (
/obj/structure/sign/departments/minsky/command/charge{
	pixel_x = -32
	},
/turf/open/floor/plasteel/dark,
/area/ai_monitored/turret_protected/aisat_interior)
"Tp" = (
/obj/effect/landmark/start/ai,
/turf/open/floor/circuit/green,
/area/ai_monitored/turret_protected/ai)
"Uh" = (
/turf/closed/wall,
/area/hallway/primary/central)
"Un" = (
/obj/effect/turf_decal/tile/darkblue{
	dir = 4
	},
/obj/structure/showcase/cyborg/old{
	pixel_y = 24
	},
/obj/machinery/camera/motion{
	c_tag = "MiniSat Foyer";
	dir = 8;
	network = list("minisat","ss13")
	},
/obj/structure/cable/yellow{
	icon_state = "4-8"
	},
/turf/open/floor/plasteel/dark,
/area/ai_monitored/turret_protected/aisat_interior)
"VM" = (
/obj/machinery/turretid{
	control_area = "/area/ai_monitored/turret_protected/aisat_interior";
	name = "Antechamber Turret Control";
	pixel_x = 32;
	req_access_txt = "19"
	},
/turf/open/floor/plasteel/dark,
/area/ai_monitored/turret_protected/aisat_interior)
"Wc" = (
/obj/structure/cable{
	icon_state = "4-8"
	},
/turf/open/floor/plasteel/dark,
/area/ai_monitored/turret_protected/aisat_interior)
"Wd" = (
/turf/closed/wall/r_wall,
/area/bridge)
"Wg" = (
/obj/structure/cable{
	icon_state = "1-2"
	},
/obj/machinery/space_heater,
/turf/open/floor/plating,
/area/ai_monitored/storage/satellite)
"Wv" = (
/obj/structure/cable/yellow{
	icon_state = "1-2"
	},
/turf/open/floor/circuit,
/area/ai_monitored/turret_protected/aisat_interior)
"WE" = (
/obj/machinery/power/apc{
	areastring = "/area/ai_monitored/turret_protected/ai";
	dir = 1;
	name = "AI Chamber APC";
	pixel_y = 23
	},
/obj/structure/cable/yellow{
	icon_state = "0-2"
	},
/turf/open/floor/circuit,
/area/ai_monitored/turret_protected/ai)
"WM" = (
/obj/effect/spawner/structure/window/reinforced,
/turf/open/floor/plating,
/area/ai_monitored/turret_protected/ai)
"WW" = (
/obj/machinery/door/airlock/hatch{
	name = "MiniSat Monitoring Room";
	req_access_txt = "65"
	},
/obj/structure/cable/yellow{
	icon_state = "4-8"
	},
/turf/open/floor/plating,
/area/space)
"Xp" = (
/obj/structure/cable/yellow{
	icon_state = "1-2"
	},
/turf/open/floor/plasteel/dark,
/area/ai_monitored/turret_protected/ai)
"Xx" = (
/obj/machinery/airalarm{
	dir = 8;
	pixel_x = 24
	},
/turf/open/floor/plasteel/grimy,
/area/ai_monitored/turret_protected/aisat_interior)
"XF" = (
/obj/structure/cable/yellow{
	icon_state = "1-2"
	},
/obj/structure/cable/yellow{
	icon_state = "1-2"
	},
/obj/machinery/door/airlock/hatch{
	name = "MiniSat Antechamber";
	req_access_txt = "65"
	},
/obj/effect/mapping_helpers/airlock/cyclelink_helper{
	dir = 1
	},
/turf/open/floor/plasteel/dark,
/area/ai_monitored/turret_protected/aisat_interior)
"XL" = (
/obj/structure/cable{
	icon_state = "2-8"
	},
/turf/open/floor/plasteel/dark,
/area/ai_monitored/turret_protected/aisat_interior)
"YU" = (
/obj/structure/cable/yellow{
	icon_state = "4-8"
	},
/obj/structure/extinguisher_cabinet{
	pixel_y = 30
	},
/turf/open/floor/plasteel/grimy,
/area/ai_monitored/turret_protected/aisat_interior)
"YY" = (
/obj/structure/cable/yellow{
	icon_state = "4-8"
	},
/turf/open/floor/plasteel/dark,
/area/ai_monitored/turret_protected/ai)
"ZQ" = (
/obj/machinery/power/terminal{
	dir = 1
	},
/obj/structure/cable{
	icon_state = "0-2"
	},
/turf/open/floor/plating,
/area/ai_monitored/storage/satellite)
"ZX" = (
/obj/effect/spawner/structure/window/reinforced/shutter,
/turf/open/floor/plating,
/area/space)

(1,1,1) = {"
qi
qi
qi
qi
qi
qi
qi
qi
qi
qi
bE
iS
lR
ZQ
Wg
Gu
fR
eN
Lu
Px
qi
"}
(2,1,1) = {"
qi
qi
RF
RF
RF
jW
RF
RF
RF
RF
bE
iS
mL
Dr
GZ
dC
Lz
tW
Lu
Px
qi
"}
(3,1,1) = {"
Wd
RF
RF
yb
lt
lt
lt
lt
yb
RF
bE
iS
iS
iS
Oy
dC
Ga
eN
Lu
Px
qi
"}
(4,1,1) = {"
Wd
RF
vj
iu
Xp
Xp
Xp
Xp
Cv
lt
bE
jm
mC
iS
WW
iS
Gr
eN
eN
Ow
qi
"}
(5,1,1) = {"
Wd
RF
lt
YY
WM
NE
RF
RF
YY
lt
bE
sw
mC
bE
Oe
Sv
Wc
ff
mC
Uh
eV
"}
(6,1,1) = {"
Wd
RF
WE
Qb
WM
lt
Tp
RF
cr
PT
vv
Wv
hT
XF
cS
mC
XL
kN
kN
mx
qi
"}
(7,1,1) = {"
Wd
RF
lt
nO
WM
kp
RF
RF
nO
lt
bE
zv
mC
bE
Un
VM
mC
MV
mC
Uh
qi
"}
(8,1,1) = {"
Wd
RF
vj
lt
nO
nO
nO
nO
lt
lt
bE
iE
mC
bE
Ny
bE
yP
eN
eN
Ow
qi
"}
(9,1,1) = {"
Wd
RF
RF
yb
lt
lt
lt
lt
yb
RF
bE
bE
bE
bE
YU
lI
eu
eN
Lu
Px
qi
"}
(10,1,1) = {"
qi
qi
RF
RF
RF
qL
RF
RF
RF
RF
bE
bE
AI
lI
cX
xt
KM
ZX
Lu
Px
qi
"}
(11,1,1) = {"
qi
qi
qi
qi
qi
qi
qi
qi
qi
qi
bE
bE
jf
Xx
EK
NM
cR
eN
Lu
Px
qi
"}
